0   0   0   0   0   0   0   0   0   0   0   0   0   0   0   0   0   0   0   0   0   0   0   0   0   0   0   0   wb  wb  wb  wbp wb  wb  wb  wb  wb  wbp wb  wb  wb  0   0   0   0   0   0   0   0   0   0   0   0   0   0   0   0   0   0   0   0   0   0   
0   0   0   0   0   wg  wg  wg  wg  wg  wg  0   0   0   0   0   0   0   0   0   0   0   0   0   0   0   0   0   wb  np  0   0   0   0   0   0   0   0   0   np  wb  0   0   0   0   0   0   0   0   0   0   0   0   0   0   0   0   0   0   0   0   0   0   
0   0   0   0   0   wg  pa8 pa8 pp1 pp1 wg  0   0   0   0   0   0   wg  wg  wg  wg  wg  wg  wg  wgf wg  wg  wg  wbp 0   0   nt  0   ebd nt  0   0   nt  0   0   wbp wb  wb  wb  wb  0   0   0   0   0   0   0   0   0   0   0   0   0   0   0   0   0   0   
0   0   0   0   0   wg  pa8 pa8 pP1 pp1 wg  0   0   0   0   0   0   wg  0   0   0   0   0   0   0   0   0   0   wb  0   0   0   0   0   0   0   0   0   0   0   wb  pp1 pp1 pp5 wb  0   0   0   0   0   0   0   0   0   0   0   0   0   0   0   0   0   0   
0   0   0   0   0   wg  pa8 pa8 pP1 pP1 0   wg  0   0   0   0   0   wg  0   nc  0   0   0   0   nc  0   0   0   dd  0   0   0   0   0   nC  0   0   0   0   ebl dd  0   0   pp1 wbp 0   0   0   0   0   0   0   0   0   0   0   0   0   0   0   0   0   0   
0   0   0   0   0   wg  pa8 pa8 pP1 0   0   wg  0   0   0   0   0   wg  0   0   0   0   0   0   0   0   0   0   wb  0   0   0   0   0   0   0   0   0   0   0   wb  pp5 pp5 pp5 wb  0   0   0   0   0   0   0   0   0   0   0   0   0   0   0   0   0   0   
0   0   0   0   0   wg  wg  wgp wg  wg  Wgp wg  wg  wgp wg  wg  0   wg  0   0   0   wg  wg  wg  wgf wg  wg  wg  wbp 0   0   0   0   0   0   0   0   0   0   0   wbp wb  wb  wb  wb  0   0   0   0   0   0   0   0   0   0   0   0   0   0   0   0   0   0   
0   0   0   0   0   wg  0   pp1 pp5 nf  0   nf  pp5 0   0   wg  0   wg  0   0   0   wg  0   0   0   0   0   0   wb  0   0   0   0   0   0   0   0   0   0   0   wb  0   0   0   0   0   0   0   0   0   0   0   0   0   0   0   0   0   0   0   0   0   0   
0   0   0   0   0   wgf 0   nl  0   0   0   pp1 0   nl  0   wgf wg  wg  0   0   0   wg  wg  wg  0   0   0   0   0   wb  wb  wbp wb  wb  dr  wb  wb  wbp wb   wb  wb  0   0   0   0   0   0   0   0   0   0   0   0   0   0   0   0   0   0   0   0   0   0   
0   0   0   0   0   wg  0   0   ebr 0   0   0   0   0   0   wg  0   0   0   ebu 0   0   0   wg  0   0   0   0   0   0   0   0   wb  0   0   0   wb  0   0   0   0   0   0   0   0   0   0   0   0   0   0   0   0   0   0   0   0   0   0   0   0   0   0   
0   0   0   0   0   wg  0   0   0   0   nt  0   ebd 0   0   dd  0   0   0   nc  0   0   0   wg  0   0   0   0   0   0   0   0   wb  0   ebd 0   wb  0   0   0   0   0   0   0   0   0   0   0   0   0   0   0   0   0   0   0   0   0   0   0   0   0   0   
0   0   0   0   0   wg  0   0   0   0   0   0   0   0   0   wg  0   0   0   0   0   ebu ph2 wg  0   0   0   0   0   0   0   0   wbp 0   nc  0   wbp 0   0   0   0   0   0   0   0   0   0   0   0   0   0   0   0   0   0   0   0   0   0   0   0   0   0   
wg  wg  wg  wg  wg  wgf pP1 nl  0   0   0   0   0   nl  0   wgf wg  wg  wg  wgp wg  wg  wg  wg  0   0   0   0   0   0   0   0   wb  0   0   0   wb  0   0   0   0   0   0   0   0   0   0   0   0   0   0   0   0   0   0   0   0   0   0   0   0   0   0   
wg  0   ph3 np  wg  wg  pP1 pP1 0   0   0   0   0   0   0   wg  0   0   0   0   0   0   0   0   0   0   0   0   0   0   0   0   wb  0   0   0   wb  0   0   0   0   0   0   0   0   0   0   0   0   0   0   0   0   0   0   0   0   0   0   0   0   0   0   
wg  0   nc  0   wg  wg  wg  wgp wg  wg  dr  wg  wg  wgp wg  0   0   0   0   0   0   0   0   0   0   0   0   wb  wb  wb  wb  wb  wb  0   0   0   wb  wb  wb  0   0   0   0   0   0   0   0   0   0   0   0   0   0   0   0   0   0   0   0   0   0   0   0   
wg  0   0   0   wg  0   0   0   wg  0   0   0   wg  0   0   0   0   0   0   0   0   0   0   0   0   0   0   wb  0   0   Wbp 0   ebr 0   nc  0   0   nf  wb  0   0   0   0   0   0   0   0   0   0   0   0   0   0   0   0   0   0   0   0   0   0   0   0   
wg  wg  dr  wg  wg  0   0   0   wgf 0   nc  0   wgf 0   0   0   0   0   0   0   0   0   0   0   0   0   0   wb  pa8 0   wb  wb  wb  0   0   0   wb  wb  wb  0   0   0   0   0   0   0   0   0   0   0   0   0   0   0   0   0   0   0   0   0   0   0   0   
wg  0   0   0   wg  wg  wg  wg  wg  0   0   0   wg  0   0   0   0   0   0   0   0   0   0   0   0   0   0   wb  pa8 ph3 wb  wb  wb  0   0   0   wb  0   0   0   0   0   0   0   0   0   0   0   0   0   0   0   0   0   0   0   0   0   0   0   0   0   0   
wg  0   nc  0   wg  0   0   ph1 wg  0   0   0   wg  0   0   0   0   0   0   0   0   0   0   0   0   0   0   wb  pgm ph3 wb  wb  wb  0   0   0   wb  0   0   0   0   0   0   0   0   0   0   0   0   0   0   0   0   0   0   0   0   0   0   0   0   0   0   
wg  0   0   0   0   0   nc  ebl wgf 0   nc  0   wgf 0   0   0   0   0   0   0   0   0   0   0   0   0   0   wb  wb  wb  wb  wb  wbp 0   nc  0   wbp 0   0   0   0   0   0   0   0   0   0   0   0   0   0   0   0   0   0   0   0   0   0   0   0   0   0   
wg  0   0   0   wg  0   0   pp5 wg  0   0   0   wg  0   0   0   0   0   0   0   0   0   0   0   0   0   0   0   0   0   0   0   wb  0   0   0   wb  0   0   0   0   0   0   0   0   0   0   0   0   0   0   0   0   0   0   0   0   0   0   0   0   0   0   
wg  0   0   0   wg  wg  wg  wg  wg  wg  dr  wg  wg  wg  wg  wg  0   0   0   0   0   0   0   0   0   0   0   0   0   0   0   0   wb  wbp dr  wbp wb  0   0   0   0   0   0   0   0   0   0   0   0   0   0   0   0   wl  wl  wl  wl  wl  wl  wl  wl  wl  wl 
wgf 0   nc  0   wgf wg  0   0   0   0   0   0   0   0   0   wg  0   0   0   0   0   0   0   0   0   0   wg  wg  wg  wg  wgf wg  nf  0   0   0   nf  wg  wgf wg  wg  wg  wg  wg  0   0   0   0   0   0   0   0   0   wl  ph1 0   0   0   0   np  np  np  wl 
wg  0   0   0   wg  wg  0   nf  0   0   0   0   0   nf  0   wgf 0   0   0   0   0   0   0   0   0   0   wg  nf  0   0   0   0   0   0   0   0   0   0   0   0   0   nf  wg  wg  0   0   0   0   0   0   0   0   0   wl  0   0   0   0   0   0   0   np  wl 
wg  0   0   0   wg  wg  0   0   nc  0   0   0   nc  0   0   wg  0   0   0   0   0   0   0   0   0   0   wgp 0   0   0   0   0   0   0   0   0   0   0   0   0   0   0   wgp wl  wl  wl  wl  wl  wl  wl  wl  wl  wl  wl  0   0   0   0   0   ebl 0   0   wl 
wg  0   0   0   0   wg  0   0   0   0   0   0   0   0   0   wg  0   0   0   0   0   0   0   0   0   0   wg  0   0   0   0   0   0   0   0   0   0   0   0   0   0   0   0   wl  0   0   0   0   0   0   0   0   0   wl  0   0   0   0   0   0   0   0   wl 
wg  0   0   0   0   dd  0   ebl 0   0   0   0   0   0   0   wgf 0   0   0   0   0   0   0   0   0   0   wg  0   0   nC  0   0   0   0   nC  0   0   0   ebl nC  0   0   0   dd  0   0   0   0   0   0   0   0   0   dd  0   0   0   0   0   0   0   0   wlb
wg  0   0   0   0   wg  0   0   0   0   0   0   0   0   0   wg  0   0   0   0   0   0   0   0   0   0   wg  0   0   0   0   0   0   0   0   0   0   0   0   0   0   0   0   wl  0   0   0   0   0   0   0   0   0   wl  0   0   0   0   0   0   0   0   wl 
wg  0   0   0   wg  wg  0   0   nc  0   0   0   nc  0   0   wg  0   0   0   0   0   0   0   0   0   0   wgp 0   0   0   0   0   0   0   0   0   0   0   0   0   0   0   wgp wl  wl  wl  0   0   0   0   wl  wl  wl  wl  edu 0   nt  ph1 0   nt  0   0   wl 
wg  0   0   0   wg  wg  0   nf  0   0   0   0   0   nf  0   wgf 0   0   0   0   0   0   0   0   0   0   wg  nf  0   0   0   0   0   0   0   0   0   0   0   0   0   nf  wg  wg  wg  wl  wl  0   0   wl  0   0   0   wl  0   0   0   0   0   0   0   0   wl 
wg  0   0   0   wg  wg  0   0   0   0   0   0   0   0   0   wg  0   0   0   0   0   0   0   0   0   0   wg  wg  wgp wg  wg  wg  0   0   0   0   0   wg  wg  wgp wg  wg  wg  0   0   0   wl  0   0   wl  0   0   0   wl  0   0   0   0   0   0   ph1 0   wl 
wgp 0   nc  0   wgp wg  wg  wg  wg  wg  dr  wg  wg  wg  wg  wg  0   0   0   0   0   0   0   0   0   0   0   0   0   0   0   wg  wl  wl  dr  wl  wl  0   0   0   0   0   0   0   0   0   wl  0   0   wl  0   0   0   wl  wl  wl  0   wl  wl  0   wl  wl  wl 
wg  0   0   0   wg  wg  wg  wg  wg  0   0   0   wg  0   0   0   0   0   0   0   0   0   0   0   0   0   0   0   0   0   0   0   wl  0   0   0   wl  0   0   0   0   0   0   0   0   0   wl  0   0   wl  0   0   0   0   0   wl  wl  wl  wl  wl  wl  0   0   
wg  0   0   0   wg  wg  wg  wg  wg  0   0   0   wg  0   0   0   0   0   0   0   0   0   0   0   0   0   0   0   0   0   0   0   wl  0   nc  0   wl  0   0   0   0   0   0   0   0   0   wl  0   0   wl  0   wl  wl  wl  wl  wl  wl  wl  wl  wl  0   0   0   
wg  0   0   0   wg  0   0   np  wg  0   0   0   wg  0   0   0   0   0   0   0   0   0   0   0   0   0   0   0   0   0   0   0   wl  0   0   0   wl  0   0   0   0   0   0   0   0   0   wl  0   0   wl  wl  wl  0   wl  0   wl  0   wl  ph1 wl  wl  0   0   
wg  0   0   0   0   0   0   0   wgf 0   nc  0   wgf 0   0   0   0   0   0   0   0   0   0   0   0   0   0   0   0   0   0   0   wl  0   0   0   wl  0   0   0   0   0   0   0   0   0   wl  0   0   0   wl  0   0   0   0   0   0   0   0   0   wl  0   0   
wg  0   0   0   wg  ph1 0   0   wg  0   0   0   wg  0   0   0   0   0   0   0   0   0   0   0   0   0   0   0   0   0   0   0   wl  0   0   0   wl  0   0   0   0   0   0   0   0   0   wl  0   0   0   dd  0   0   0   0   0   0   0   0   0   wlb 0   0   
wg  0   nc  0   wg  wg  wg  wg  wg  0   0   0   wg  0   0   0   0   0   0   0   0   0   0   0   0   0   0   0   0   0   0   0   wl  0   nc  0   wl  0   0   0   0   0   0   0   0   0   wl  0   ebu 0   wl  0   0   0   0   0   0   0   0   0   wl  0   0   
wg  0   0   0   wg  wg  wg  wg  wg  0   ebu 0   wg  wg  wg  wg  wg  wg  wg  wg  wg  wgp wg  wg  wg  0   0   0   0   0   0   0   wl  0   0   0   wl  0   0   0   0   0   0   0   0   0   wl  wl  wl  wl  wl  wl  0   wl  0   wl  0   wl  0   wl  wl  0   0   
wg  0   0   0   0   0   0   0   0   0   0   0   0   0   0   0   0   wg  0   0   0   0   0   0   wgf wg  wg  0   0   0   0   0   wl  0   0   0   wl  0   0   0   0   0   0   0   0   0   0   0   0   0   0   wl  wl  wl  wl  wl  wl  wl  wl  wl  0   0   0   
wg  0   0   0   0   0   nc  0   0   0   0   0   0   0   nc  0   0   dd  0   0   0   ebl 0   0   Ded ll  wg  0   0   0   0   0   wl  0   0   0   wl  0   0   0   0   0   0   0   0   0   0   0   0   0   0   0   0   0   0   0   0   0   0   0   0   0   0   
wg  0   0   0   0   0   0   0   0   0   0   0   0   0   0   0   0   wg  0   0   0   0   0   ebl wgf wg  wg  0   0   0   0   0   wl  0   nc  0   wl  0   0   0   0   0   0   0   0   0   0   0   0   0   0   0   0   0   0   0   0   0   0   0   0   0   0   
wg  wg  wg  wg  wg  wg  wg  wg  wg  wg  wgp wg  wg  wg  wg  wg  wg  wg  Wg  wg  wg  wgp wg  wg  wg  0   0   0   0   0   0   0   wl  0   0   0   wl  0   0   0   0   0   0   0   0   0   0   0   0   0   0   0   0   0   0   0   0   0   0   0   0   0   0   
0   0   0   0   0   0   0   0   0   0   wg  wgf 0   0   wg  0   0   Wg  0   ph3 wg  0   0   0   0   0   0   wl  wl  wl  wl  wl  wl  wl  dr  wl  wl  wl  wl  wl  wl  wl  0   0   0   0   0   0   0   0   0   0   0   0   0   0   0   0   0   0   0   0   0   
0   0   0   0   0   0   0   0   0   wg  pu  0   0   0   wg  0   0   wg  0   wg  0   0   0   0   0   0   0   wl  0   ph1 0   0   wl  0   0   0   wl  0   0   0   0   wl  0   0   0   0   0   0   0   0   0   0   0   0   0   0   0   0   0   0   0   0   0   
0   0   0   0   0   0   0   0   0   0   wg  wgf 0   0   0   0   0   wg  wg  0   0   0   0   0   0   0   0   wl  0   0   0   0   dd  0   0   0   dd  0   0   0   0   wl  0   0   0   0   0   0   0   0   0   0   0   0   0   0   0   0   0   0   0   0   0   
0   0   0   0   0   0   0   0   0   0   0   0   wg  Wg  wg  wg  wg  wg  0   0   0   0   0   0   0   0   0   wl  0   0   0   0   wl  0   nc  0   wl  0   0   0   0   wl  0   0   0   0   0   0   0   0   0   0   0   0   0   0   0   0   0   0   0   0   0   
0   0   0   0   0   0   0   0   0   0   0   0   wg  0   0   wg  0   0   0   0   0   0   0   0   0   0   0   wl  0   0   0   0   wl  0   0   0   wl  0   0   0   0   wl  0   0   0   0   0   0   0   0   0   0   0   0   0   0   0   0   0   0   0   0   0   
0   0   0   0   0   0   0   0   0   0   0   0   wg  0   pgc wg  0   0   0   0   0   0   0   0   0   0   0   wl  wl  wl  wl  wl  wl  0   0   0   wl  wl  wl  wl  wl  wl  0   0   0   0   0   0   0   0   0   0   0   0   0   0   0   0   0   0   0   0   0   
0   0   0   0   0   0   0   0   0   0   0   0   wg  wg  wg  wg  0   0   0   0   0   0   0   0   0   0   0   wl  0   0   0   0   wl  0   0   0   wl  0   0   0   0   wl  0   0   0   0   0   0   0   0   0   0   0   0   0   0   0   0   0   0   0   0   0   
0   0   0   0   0   0   0   0   0   0   0   0   0   0   0   0   0   0   0   0   0   0   0   0   0   0   0   wl  0   0   0   0   dd  0   nc  0   dd  ph1 0   0   0   wl  0   0   0   0   0   0   0   0   0   0   0   0   0   0   0   0   0   0   0   0   0   
0   0   0   0   0   0   0   0   0   0   0   0   0   0   0   0   0   0   0   0   0   0   0   0   0   0   0   wl  0   0   0   0   wl  0   0   0   wl  0   0   0   0   wl  0   0   0   0   0   0   0   0   0   0   0   0   0   0   0   0   0   0   0   0   0   
0   0   0   0   0   0   0   0   0   0   0   0   0   0   0   0   0   0   0   0   0   0   0   0   0   0   0   wl  wl  wl  wl  wl  wl  0   0   0   wl  wl  wl  wl  wl  wl  0   0   0   0   0   0   0   0   0   0   0   0   0   0   0   0   0   0   0   0   0   
0   0   0   0   0   0   0   0   0   0   0   0   0   0   0   0   0   0   0   0   0   0   0   0   0   0   0   wl  0   0   0   0   0   0   0   0   0   0   0   0   0   wl  0   0   0   0   0   0   0   0   0   0   0   0   0   0   0   0   0   0   0   0   0   
0   0   0   0   0   0   0   0   0   0   0   0   0   0   0   0   0   0   0   0   0   0   0   0   0   0   0   wl  0   0   nc  0   0   0   nc  0   0   0   nc  ebl pa8 wl  0   0   0   0   0   0   0   0   0   0   0   0   0   0   0   0   0   0   0   0   0   
0   0   0   0   0   0   0   0   0   0   0   0   0   0   0   0   0   0   0   0   0   0   0   0   0   0   0   wl  0   0   0   0   0   0   ph1 0   0   0   0   0   0   wl  0   0   0   0   0   0   0   0   0   0   0   0   0   0   0   0   0   0   0   0   0   
0   0   0   0   0   0   0   0   0   0   0   0   0   0   0   0   0   0   0   0   0   0   0   0   0   0   0   wl  wlb wl  wl  wlb wl  wl  wlb wl  wl  wlb wl  wl  wlb wl  0   0   0   0   0   0   0   0   0   0   0   0   0   0   0   0   0   0   0   0   0   
end
50 29 0